→→→→→→↓↓←←
→→↑←↑↓→↓→↑
↑←↓↑↑→↓↓↑←
↑←←↑↑↓↓→↓↑
↓↓→↓←←↓↓←←
→→↓←→↓←←↑←
↑←↓→↓↓→↑↑↑
↓↓↓←→↓→↑↑↑
→→↓→→←←→→↓
→↑→↑←←↑←←←
