9111111113
8000000002
8000000002
8000000002
8000000002
8000000002
8000000002
8000000002
8000000002
C444444446
